#####
#*###
# ###
#   #
# ###
#  +#
#####
